sentence	expected_response	assistant_response
M Dark grey staining in the intestine long arrows and in somatic gonad cells short arrows indicates hybridization of the anti-sense probe to the acs-1 transcript	This sentence only contains fully curatable data.	This sentence only contains fully curatable data.
We found that VPS-32 1 :GFP localized to cytosolic vesicles with a punctate pattern as having been shown previously Michelet et al 2009 while VPS- 4 :mKate2 was diffuse in the cytosol Figure S7E	This sentence only contains fully curatable data.	This sentence only contains fully curatable data.
syx-2 is expressed in both epidermis and neurons	This sentence only contains fully curatable data.	This sentence only contains fully curatable data.
NMGP-1 also appeared to localize on the cell surface arrowheads in Figure 3a	This sentence only contains fully curatable data.	This sentence only contains fully curatable data.
Cells labeled by Pnmgp-1 :GFP could be CAN and HSN neurons arrows	This sentence only contains fully curatable data.	This sentence only contains fully curatable data.
Arrows point to tail ganglia and indicate nmgp-1 expression	This sentence only contains fully curatable data.	This sentence only contains fully curatable data.
HECD-1 is ubiquitously expressed in the embryo	This sentence only contains fully curatable data.	This sentence only contains fully curatable data.
Using a fluorescent anti-FLAG antibody in fixed embryos expression of HECD-1 was ubiquitous in the cytoplasm of the developing embryo but was absent from the nucleus Fig 6a Supplementary Fig 5b	This sentence only contains fully curatable data.	This sentence only contains fully curatable data.
However embryonic FLAG :HECD-1 had ubiquitous cytosolic expression including during both meiosis and mitosis with no detectible enrichment on microtubules Fig 6	This sentence only contains fully curatable data.	This sentence only contains fully curatable data.
Embryos had ubiquitous FLAG :HECD-1 localization in the cytoplasm but this was absent from the nucleus	This sentence only contains fully curatable data.	This sentence only contains fully curatable data.
A functional transcriptional reporter for CKR-1 revealed strong expression in many neurons and weak expression in the intestine Figure 4A	This sentence only contains fully curatable data.	This sentence only contains fully curatable data.
We found that kin-36 indeed displays pan-pharyngeal neuron expression expression is also observed in all other pharyngeal cell types but no cell types outside the pharynx except some unidentified vulval cells Figure 6C	This sentence only contains fully curatable data.	This sentence only contains fully curatable data.
A eya-1 is expressed in all pharyngeal neurons throughout the life of the worm	This sentence only contains fully curatable data.	This sentence only contains fully curatable data.
GFP :HDA-2 was strongly expressed in adult animals in the nerve ring pharynx distal tip cells sheath cells and uterus Fig 3c–h	This sentence only contains fully curatable data.	This sentence only contains fully curatable data.
daf-37 and daf-38 Are Expressed in Chemosensory Neurons	This sentence only contains fully curatable data.	This sentence only contains fully curatable data.
Using a gfp-reporter construct we showed that DAF-38 was expressed in the same head neurons as DAF-37 Fig 4B but not in any other amphid cells	This sentence only contains fully curatable data.	This sentence only contains fully curatable data.
SER-2 and TPH-1 are coexpressed in nsm neurons	This sentence only contains fully curatable data.	This sentence only contains fully curatable data.
SNA-3 :GFP is expressed in somatic and germline nuclei throughout development	This sentence only contains fully curatable data.	This sentence only contains fully curatable data.
A–C SNA-3 :GFP in the sperm and oocyte nuclei of the one cell embryo A and in the zygotic nuclei of two and four cell embryos B and C respectively	This sentence only contains fully curatable data.	This sentence only contains fully curatable data.
The DAF-2 :mNeonGreen-expressing neurons included all of the ciliated sensory neurons marked by the osm-6 promoter-driven mCherry protein Supplementary Fig 2a	This sentence only contains fully curatable data.	This sentence only contains fully curatable data.
DAF-16 FoxO is widely expressed from embryos to adults	This sentence only contains fully curatable data.	This sentence only contains fully curatable data.
We confirmed that the endogenously expressed CHDP-1 mainly localizes to the cell cortex and is expressed in many cell types if not all including the cell bodies of the PVD neurons	This sentence only contains fully curatable data.	This sentence only contains fully curatable data.
We found that the N-terminal LPD-3Nt :mCherry signals were closely surrounded by ER membrane markers Fig 2e	This sentence only contains partially curatable data.	This sentence only contains fully curatable data.
We observed NOCA-2 accumulations in several spots in the head and tail of the animal Fig 4A and at the cortex of the epidermal seam cells Fig 4B	This sentence only contains fully curatable data.	This sentence only contains fully curatable data.
Importantly we detected NOCA-2 :GFP in the distal PVD dendrite during neuronal development which showed a similar localization pattern and dynamics as GIP-2 and RAB-11 Fig 4C and 4D and S3 Video	This sentence only contains fully curatable data.	This sentence only contains fully curatable data.
Consistently transgenic worms expressing mCherry under the daf-42 promoter showed expression in seam cells between 48 and 60 HAE Fig 4b which corresponds to the time of appearance of the dead L2d phenotype Fig 1d	This sentence only contains fully curatable data.	This sentence only contains fully curatable data.
We found that a functional KPC-1 sfGFP reporter specifically expressed in PVD localized to higher-order dendritic branches of PVD neurons as well as to the PVD axonal compartment Fig 5A Fig S4A	This sentence only contains fully curatable data.	This sentence only contains fully curatable data.
We also observed weak and inconsistent expression in other head neurons and transient weak expression in the tail of hermaphrodites and males at the L4 stage not analyzed	This sentence only contains partially curatable data.	This sentence only contains partially curatable data.
GFP expression is not detectable in the somatic gonad arrow in V	This sentence only contains partially curatable data.	This sentence only contains partially curatable data.
Arrowheads point to GFP signal localized at the plasma membrane black arrows point to filopodia and white arrows indicate GFP signal accumulated in the perinuclear zone	This sentence only contains partially curatable data.	This sentence only contains partially curatable data.
Strong GFP expression is observed in all four CEPsh glia Fig 1e	This sentence only contains partially curatable data.	This sentence only contains partially curatable data.
Overlapping of images from NeuroPAL fluorophores and GFP expression under the nmgp-1 promoter is shown on the right	This sentence only contains partially curatable data.	This sentence only contains partially curatable data.
Fluorescent images showing the distribution of NMY-2 :GFP	This sentence only contains partially curatable data.	This sentence only contains partially curatable data.
L-Q DIC and fluorescent images of PAR-2 :GFP	This sentence only contains partially curatable data.	This sentence only contains partially curatable data.
Expression pattern of the Psrg-36 :srg-36 :sl2 :gfp gene	This sentence only contains partially curatable data.	This sentence only contains partially curatable data.
g Image of the worm s medial region expressing NeuroPAL fluorophores left	This sentence only contains partially curatable data.	This sentence only contains partially curatable data.
HDA-2 expression in adult animals	This sentence only contains partially curatable data.	This sentence only contains partially curatable data.
HDA‐2 expression	This sentence only contains partially curatable data.	This sentence only contains partially curatable data.
Accordingly analysis of nmgp-1 reporter expression showed labelling of many head neurons including sensory ones	This sentence only contains fully curatable data.	This sentence only contains fully curatable data.
The acs-1 full :GFP construct was made by PCR amplification using the same forward primer listed above but a different reverse primer aagctcggagaaatgagag so that the coding region ended at the last codon before the stop-codon and this was translationally fused with GFP	This sentence is not fully or partially curatable, but it contains terms related to the datatype.	This sentence is not fully or partially curatable, but it contains terms related to the datatype.
In addition to identify specific neurons we used the NeuroPAL strain OH15500 developed by Hobert s Lab Yemini et al 2021	This sentence is not fully or partially curatable, but it contains terms related to the datatype.	This sentence is not fully or partially curatable, but it contains terms related to the datatype.
RNA in situ hybridization	This sentence is not fully or partially curatable, but it contains terms related to the datatype.	This sentence is not fully or partially curatable, but it contains terms related to the datatype.
The same construct 50 ng μl and 50 ng μl using Pcoel :GFP as green coelomocyte co-injection marker was used to inject the NeuroPAL strain OH15500 to identify the neurons expressing nmgp-1	This sentence is not fully or partially curatable, but it contains terms related to the datatype.	This sentence is not fully or partially curatable, but it contains terms related to the datatype.
These results indicated that expression of acs-1 in the germline if any was not essential for embryogenesis and that its expression in somatic cells was necessary and sufficient for this function	This sentence is not fully or partially curatable, but it contains terms related to the datatype.	This sentence is not fully or partially curatable, but it contains terms related to the datatype.
Tissue specificity of ACS-1 functions	This sentence is not fully or partially curatable, but it contains terms related to the datatype.	This sentence is not fully or partially curatable, but it contains terms related to the datatype.
The normal distribution of C17ISO between lipid species in wild-type embryos depends on acs-1 expression in the somatic gonad	This sentence is not fully or partially curatable, but it contains terms related to the datatype.	This sentence is not fully or partially curatable, but it contains terms related to the datatype.
Since transgenic GFP expression may be silent in the germline and RNA in situ hybridization may not be sensitive enough to detect very low levels of acs-1 germ-line expression we performed germline-specific RNAi analysis to determine whether there was a requirement for acs-1 germline expression	This sentence is not fully or partially curatable, but it contains terms related to the datatype.	This sentence is not fully or partially curatable, but it contains terms related to the datatype.
The acox-1 1 gene functions in the intestine and hypodermis where it contributes to the biosynthesis of ascaroside pheromones Joo et al 2010	This sentence is not fully or partially curatable, but it contains terms related to the datatype.	This sentence is not fully or partially curatable, but it contains terms related to the datatype.
Furthermore it has been shown that max-2 is expressed during early development but not at the young adult stage Lucanic et al 2006	This sentence is not fully or partially curatable, but it contains terms related to the datatype.	This sentence is not fully or partially curatable, but it contains terms related to the datatype.
The egl-4 gene is expressed in various cells including many neurons and controls multiple biological processes that includes egg-laying body size regulation chemotaxis and foraging Daniels et al 2000 Fujiwara et al 2002 Hao et al 2011	This sentence is not fully or partially curatable, but it contains terms related to the datatype.	This sentence is not fully or partially curatable, but it contains terms related to the datatype.
The DBL-1 receptor SMA-6 and the downstream transcription factors SMA-2 and SMA-3 are expressed in the hypodermis and regulate gene expression to control the size of hypodermal cells which in turn determines the size of C elegans	This sentence is not fully or partially curatable, but it contains terms related to the datatype.	This sentence is not fully or partially curatable, but it contains terms related to the datatype.
In C elegans all CSR-1 pathway members display similar mutant phenotypes sterility embryonic lethality and changes in chromatin developmental expression profiles and localization patterns with highest expression in the germline and embryos 16,18,20,22,36	This sentence is not fully or partially curatable, but it contains terms related to the datatype.	This sentence is not fully or partially curatable, but it contains terms related to the datatype.
SER-2 is widely expressed in a set of sensory inter- and motor-neurons for example AIY AIZ and RIA as well as in pharyngeal NSM cells and head muscles35	This sentence is not fully or partially curatable, but it contains terms related to the datatype.	This sentence only contains fully curatable data.
Under standard growth conditions KIN-29 localizes to the cytosol but in response to cell stress induced by high heat exposure KIN-29 moves into the nucleus 29	This sentence is not fully or partially curatable, but it contains terms related to the datatype.	This sentence only contains fully curatable data.
While mammalian TRX-1 is ubiquitously expressed C elegans TRX-1 expression is restricted to worm ASJ sensory neurons 23 which have been shown to regulate dauer entry and exit 30	This sentence is not fully or partially curatable, but it contains terms related to the datatype.	This sentence is not fully or partially curatable, but it contains terms related to the datatype.
For example Tran et al 2013 found that elimination of mammalian HECTD1 changed the localization of a ß-catenin degradation complex from the cytoplasm to the cortex in cultured cells	This sentence is not fully or partially curatable, but it contains terms related to the datatype.	This sentence is not fully or partially curatable, but it contains terms related to the datatype.
qIs51 an integrated version of ccEx9747 contains the following markers myo-2 :GFP expressed in the pharynx throughout development pes-10 :GFP expressed in the embryo and F22B7 9 :GFP expressed in the intestine	This sentence is not fully or partially curatable, but it contains terms related to the datatype.	This sentence is not fully or partially curatable, but it contains terms related to the datatype.
Expression of CKR-1 in AIB robustly rescued ckr-1 mutant animal ’ s escape defects Figure 4C	This sentence is not fully or partially curatable, but it contains terms related to the datatype.	This sentence is not fully or partially curatable, but it contains terms related to the datatype.
Moreover the expression of acs-1 full TGFP in only one of the two gonads did not rescue the Emb phenotype in the other Fig 2H–M	This sentence is not fully or partially curatable, but it contains terms related to the datatype.	This sentence is not fully or partially curatable, but it contains terms related to the datatype.
Briefly when acs-1 expression was disrupted in the intestine but not in the somatic gonad in the presence of dietary C17ISO it did not result in Emb Supplemental Fig S2W–ac Supplemental Material	This sentence is not fully or partially curatable, but it contains terms related to the datatype.	This sentence is not fully or partially curatable, but it contains terms related to the datatype.
Blue indicates the touch neuron of acox-1 2 mutants expressing the acox-1 2 gene	This sentence is not fully or partially curatable, but it contains terms related to the datatype.	This sentence is not fully or partially curatable, but it contains terms related to the datatype.
We performed axotomy on aged worms expressing a functional EFF-1 :mCherry transgene shrEx59 and found that at A3 and A4 the FR index of fusion events in these worms 0 35 ± 0 043 and 0 24 ± 0 035 re- spectively is higher than the respective indices in wild-type worms 0 02 ± 0 05 and −0 029 ± 0 02 respectively Fig 6I	This sentence is not fully or partially curatable, but it contains terms related to the datatype.	This sentence is not fully or partially curatable, but it contains terms related to the datatype.
Strikingly none of these post-fertilization hallmarks were observed in either acs- 1 RNAi C17ISO or embryos from acs-1 gk3066 Ex acs- 1 full TGFP animals that lost acs-1 expression in the somatic gonad	This sentence is not fully or partially curatable, but it contains terms related to the datatype.	This sentence is not fully or partially curatable, but it contains terms related to the datatype.
H–M DIC and fluorescence images illustrating a tight correlation between the absence of somatic gonad expression of the acs-1 full TGFP transgene in acs-1 gk3066 mutant worms and the Emb phenotype	This sentence is not fully or partially curatable, but it contains terms related to the datatype.	This sentence is not fully or partially curatable, but it contains terms related to the datatype.
Note EFF-1 :GFP formed puncta and localized at the wound site at 1 h p w	This sentence is not fully or partially curatable, but it contains terms related to the datatype.	This sentence only contains fully curatable data.
Furthermore nos-3 mRNA was present throughout development increasing in abundance at the L4 larval stage just before oocytes first appear Figure 3a lanes 3–9	This sentence only contains fully curatable data.	This sentence only contains fully curatable data.
G–L Beginning in the L3 Plet-7 :gfppest expression is detected in seam G and H black arrows and vulva precursor cells I and J white arrows as well as the body wall muscle K asterisk and L in addition to the tissues observed in L1 L2 stage animals	This sentence only contains fully curatable data.	This sentence only contains fully curatable data.
M–P Plet-7 :gfppest is expressed strongly in the vulva M and N and seam O black arrows and P during the L4	This sentence only contains fully curatable data.	This sentence only contains fully curatable data.
GFP :hlh-13 expression was also observed in several unidentified ventral nerve cells from L2 to L4 stages Fig 7A	This sentence only contains fully curatable data.	This sentence only contains fully curatable data.
We observed the GFP :hlh-13 reporter in developing and adult worms and found that the full-length GFP :hlh-13 transgene was expressed in all the hermaphrodite dopaminergic neurons ADE CEP and PDE throughout development and adulthood although the expression declined with age and in several unidentified neurons in the ventral nerve cord during L2 and L3 developmental stages Fig 2 Supplemental Fig 2 and data not shown	This sentence only contains fully curatable data.	This sentence only contains fully curatable data.
LNKN-1 is localized to the plasma membrane exhibiting stronger localization to the sides of cell–cell contact in tissues such as the intestine seam and gonad	This sentence only contains fully curatable data.	This sentence only contains fully curatable data.
BAR-1-GFP expression first appeared in P11 p in the late L1 stage Figs 6C D	This sentence only contains fully curatable data.	This sentence only contains fully curatable data.
Transgenic animals expressed this reporter specifically in muscle Figure 1	This sentence only contains partially curatable data.	This sentence only contains partially curatable data.
First LID-1 is constitutively localized at lipid droplets Fig 2D	This sentence only contains fully curatable data.	This sentence only contains fully curatable data.
The results revealed that cey-1 and cey-4 were present in both the soma and the germline whereas cey-2 and cey-3 were only expressed in the germline Figure 1C and D	This sentence only contains fully curatable data.	This sentence only contains fully curatable data.
In larvae and adults NEKL-3 :GFP was observed in hyp7 and other hypodermal cells but not in seam cells	This sentence only contains fully curatable data.	This sentence only contains fully curatable data.
This fusion was also expressed in the ALM mechanosensory neurons Fig 5c which can explain the egl-2 gf anterior Mec phenotype Table 1	This sentence only contains partially curatable data.	This sentence only contains fully curatable data.
In wild-type animals col-19 :gfp was expressed in the hypodermal syncytial hyp7 cells and 16 seam cells Fig 2A 2B and 2E	This sentence only contains fully curatable data.	This sentence only contains fully curatable data.
First only TSP-14A but not TSP-14B is detectable in the germline and sperm cells as well as at the tip of the anterior sensory cilia Fig 5A and 5B while TSP-14B is detectable in the pharynx Fig 5F	This sentence only contains fully curatable data.	This sentence only contains fully curatable data.
In the developing vulva TSP-14A is localized on the apical side while TSP-14B is localized on the basolateral membrane compare Fig 5E vs 5I and Fig 5R vs 5U for worms at the L4 Christmas-tree stage	This sentence only contains fully curatable data.	This sentence only contains fully curatable data.
Based on colocalization analysis using AVH-specific and AIB-specific markers respectively we determined that a frpr-14 translational GFP reporter was expressed in the AVH and AIB interneuron classes Figure 2A Figure S2A B BENDENA et al 2008 COOK et al 2021	This sentence only contains fully curatable data.	This sentence only contains fully curatable data.
The gly-18 promoter drives expression of a GFP reporter in the DTCs beginning prior to their first phase migration and continuing to the adult stage S4A Fig and Fig 1A	This sentence only contains fully curatable data.	This sentence only contains fully curatable data.
We observed that TRIM-21 :mCherry was ubiquitously expressed in the worms and appeared to be localized in the cytoplasm	This sentence only contains fully curatable data.	This sentence only contains fully curatable data.
Expression of HA :NYN-3 was only detected in the proximal germ line and disappeared rapidly upon spermatid formation Fig 2A	This sentence only contains fully curatable data.	This sentence only contains fully curatable data.
To reconstruct the mitochondria in embryos, the images were analyzed using IMARIS 9 software.	This sentence does not contain fully or partially curatable data, or terms related to the datatype.	This sentence does not contain fully or partially curatable data, or terms related to the datatype.
The sms-5(0) mutant is hypersensitive to 139 of these 140 molecules (99%) plus an additional 48 molecules that kill wild type and pgp-14(0) mutants equally (Fig 7E and S1 Data).	This sentence does not contain fully or partially curatable data, or terms related to the datatype.	This sentence does not contain fully or partially curatable data, or terms related to the datatype.
Here, we conducted soil toxicity tests using the nematode Caenorhabditis elegans as a model organism, and 13 microplastics were chosen as target materials; six different compositions (high-density polyethylene, HDPE; poly-(ethylene terephthalate), PET; polypropylene, PP; polystyrene, PS; low-density polyethylene, LDPE; polyacrylonitrile, PAN) and three different shapes (fragments, film, fibers) with one to three different size ranges (Table S1).	This sentence does not contain fully or partially curatable data, or terms related to the datatype.	This sentence does not contain fully or partially curatable data, or terms related to the datatype.
The IDT CRISPR HDR design tool (https://www.idtdna.com/pages/tools/alt-r-crispr-hdr-design-tool) was used to generate repair templates and guide sequences.	This sentence does not contain fully or partially curatable data, or terms related to the datatype.	This sentence does not contain fully or partially curatable data, or terms related to the datatype.
Protein expression was induced with 1mM IPTG in 400 mL of BL21 DE3 pLys cells at OD = 0.6-0.8, by incubation at 25 C for 3 h.	This sentence is not fully or partially curatable, but it contains terms related to the datatype.	This sentence does not contain fully or partially curatable data, or terms related to the datatype.
Modifications affecting lysine residues such as ubiquitination and sumoylation modulate the activities of numerous proteins including TGFb and Wnt pathway components.	This sentence does not contain fully or partially curatable data, or terms related to the datatype.	This sentence does not contain fully or partially curatable data, or terms related to the datatype.
Therefore, it will be critical to identify components that integrate histone marks with gene expression, such as CRTC-1.	This sentence is not fully or partially curatable, but it contains terms related to the datatype.	This sentence is not fully or partially curatable, but it contains terms related to the datatype.
The AB128 stage occurs about 190 min after fertilization, when the ventral cleft appears.	This sentence does not contain fully or partially curatable data, or terms related to the datatype.	This sentence does not contain fully or partially curatable data, or terms related to the datatype.
Duplicate or triplicate agar plates were used for each CFU determination.	This sentence does not contain fully or partially curatable data, or terms related to the datatype.	This sentence does not contain fully or partially curatable data, or terms related to the datatype.
The role of hox genes in cell cycle regulation is of particular importance during cancer formation, where increased hox gene expression induced by oncogenes, growth factors or epigenetic changes drives tumor cell proliferation (reviewed in 6,7,12,13 ).	This sentence is not fully or partially curatable, but it contains terms related to the datatype.	This sentence is not fully or partially curatable, but it contains terms related to the datatype.
We found that both pgp-14 and sms-5 null mutants have obviously less NR signal associated with the cuticle compared to the wild type (Fig 6A -6C).	This sentence only contains partially curatable data.	This sentence is not fully or partially curatable, but it contains terms related to the datatype.
To identify the critical periods for food type-dependent effects on onset of oogenesis and on fertilization, we grew worms on one food type and switched them to the second food type at different stages of larval development.	This sentence does not contain fully or partially curatable data, or terms related to the datatype.	This sentence does not contain fully or partially curatable data, or terms related to the datatype.
As shown in Table 1, the MIC of PQ401 was 4 g/ml against all of the MRSA strains tested as well as the VRSA strain VRS1 (Table 1).	This sentence does not contain fully or partially curatable data, or terms related to the datatype.	This sentence does not contain fully or partially curatable data, or terms related to the datatype.
Does this mean the last 4 days that were used in the analysis according to Lyu et al. 2019 or did the mice spend four times seven days in the running wheel?	This sentence does not contain fully or partially curatable data, or terms related to the datatype.	This sentence does not contain fully or partially curatable data, or terms related to the datatype.
Separately, inactivation of AP-1 components, JUN-1 and FOS-1 alone does not suppress set-2 longevity (Fig. 2j,k), probably due to redundancy with other AP-1 components 32 .	This sentence does not contain fully or partially curatable data, or terms related to the datatype.	This sentence does not contain fully or partially curatable data, or terms related to the datatype.
To verify that the potential loss of CS180 cue(s) was not due to the cue(s) adsorbing to the membrane, we pre-incubated 3-4 ml of the CS180-conditioned medium with a postage stamp-sized 0.45 μm diameter nylon membrane.	This sentence does not contain fully or partially curatable data, or terms related to the datatype.	This sentence does not contain fully or partially curatable data, or terms related to the datatype.
Purification of GST-tagged LMN-1, LMN-1 H , and LMN-1 T fragments GST-LMN-1 was amplified from cDNA and cloned in pETM30 protein expression vector (6xHis-GST-TEV-LMN-1) and the purification was done as described. 15	This sentence is not fully or partially curatable, but it contains terms related to the datatype.	This sentence is not fully or partially curatable, but it contains terms related to the datatype.
All in vitro results below used YP-terpenes.	This sentence does not contain fully or partially curatable data, or terms related to the datatype.	This sentence does not contain fully or partially curatable data, or terms related to the datatype.
GSY-1 is the C. elegans homolog of the mammalian glycogen synthase GYS.	This sentence does not contain fully or partially curatable data, or terms related to the datatype.	This sentence does not contain fully or partially curatable data, or terms related to the datatype.
The crh-1(n3315) mutant was provided by Mark Alkema.	This sentence does not contain fully or partially curatable data, or terms related to the datatype.	This sentence does not contain fully or partially curatable data, or terms related to the datatype.
The mass spectrometry analyzer operated in data-dependent acquisition mode with a top ten method at a 300-2,000 Da mass range.	This sentence does not contain fully or partially curatable data, or terms related to the datatype.	This sentence does not contain fully or partially curatable data, or terms related to the datatype.
Thus, we explored the potential nature of the CS180-derived cue(s) that affect oocyte physiology and supplemented OP50-fed worms with CS180-conditioned media.	This sentence does not contain fully or partially curatable data, or terms related to the datatype.	This sentence does not contain fully or partially curatable data, or terms related to the datatype.
Smads were as follows: Ce Sma-2, NP_498931; Ce Sma-3, NP_498493; Ce Sma-4, NP_001040864; Ce Daf-3 iso-a, AAK68348; Ce Daf-3 iso-b, AAM54188; Ce Daf-3 iso-c, AAM54189; Ce Daf-8, NP_492321; Ce Daf-14, NP_501880; Ce 1L81 (Tag-68), NP_492746; Dm Med iso-a, NP_524610; Dm Med iso-b, NP_733438; Dm dSmad2, NP_511079; Dm Mad, NP_477017; Dm Dad, AAN13728; Mm Smad1, AAG41407; Mm Smad2 iso-a, EDL09484; Mm Smad2 iso-b, EDL09485; Mm Smad3, AAB81755; Mm Smad4 iso-a, EDL09559; Mm Smad4 iso-b, EDL09560; Mm Smad4 iso-c, EDL09561; Mm Smad5, AAC83580; Mm Smad6, AAB81351; Mm Smad7 iso-a, EDL09492; Mm Smad7 iso-b, EDL09493; and Mm Smad8/9, AAN85445.	This sentence does not contain fully or partially curatable data, or terms related to the datatype.	This sentence does not contain fully or partially curatable data, or terms related to the datatype.
The data are representative of at least three independent experiments.	This sentence does not contain fully or partially curatable data, or terms related to the datatype.	This sentence does not contain fully or partially curatable data, or terms related to the datatype.
In contrast, T. muris whipworms do not ingest YPs and the terpene mode of action on this whipworm depends only on terpene release from YPs into the medium.	This sentence does not contain fully or partially curatable data, or terms related to the datatype.	This sentence does not contain fully or partially curatable data, or terms related to the datatype.
Specifically, RIC-8 functions as a chaperone that promotes folding of nascent Gα subunits prior to their incorporation into the heterotrimeric complex with Gβγ and regulates their membrane localization [29,[31][32][33].	This sentence is not fully or partially curatable, but it contains terms related to the datatype.	This sentence is not fully or partially curatable, but it contains terms related to the datatype.
4mcPred-IFL adopted an iterative feature representation algorithm, which reached the maximum when the number of iterations was 30 and ACC was 0.9001, and then gradually converges to a stable state.	This sentence does not contain fully or partially curatable data, or terms related to the datatype.	This sentence does not contain fully or partially curatable data, or terms related to the datatype.
GC-MS data were converted to *.abf files and submitted to MS-DIAL software.	This sentence does not contain fully or partially curatable data, or terms related to the datatype.	This sentence does not contain fully or partially curatable data, or terms related to the datatype.
Compared to wild-type N2, ATP levels were significantly reduced in atgl-1(xd314) embryos measured by bioluminescence assay (Fig 3H).	This sentence is not fully or partially curatable, but it contains terms related to the datatype.	This sentence does not contain fully or partially curatable data, or terms related to the datatype.
However, the daf-2(e1370) mutant fertilization rate on OP50 still differed from that on CS180 (Figure 8B, Figure 8-source data 1).	This sentence does not contain fully or partially curatable data, or terms related to the datatype.	This sentence does not contain fully or partially curatable data, or terms related to the datatype.
BLI-1-like collagens with extended N-and C-terminal domains can be identified in the genomes of multiple species in the Caenorhabditis genus 45 , with highest similarity to BLI-1 within the Elegans supergroup.	This sentence does not contain fully or partially curatable data, or terms related to the datatype.	This sentence does not contain fully or partially curatable data, or terms related to the datatype.
Considering the pleiotropic effects of insulin signaling on metazoan reproduction (Das and Arur, 2017), it is possible that the multiple ILPs present in other animals (Allen et al., 2015) will also have specific roles in coordinating oogenesis with fluctuations in a given environment.	This sentence does not contain fully or partially curatable data, or terms related to the datatype.	This sentence does not contain fully or partially curatable data, or terms related to the datatype.
Phytochemical studies have suggested the presence of several types of alkaloids and terpenoids, such as sesquiterpenoids, diterpenoids, and triterpenoids, which are known to possess various biological activities, including cytotoxicity and antiinflammatory activities [2,9].	This sentence does not contain fully or partially curatable data, or terms related to the datatype.	This sentence does not contain fully or partially curatable data, or terms related to the datatype.
However, the GFP-B55 SUR-6 fluorescence intensity is significantly enriched inside the male pronucleus $50 s before the NEP of the female pronucleus (Figures S5D andS5E; Video S8).	This sentence only contains partially curatable data.	This sentence only contains fully curatable data.
Since global knockout of ric-8 results in full-body paralysis due to the role of ric-8 in regulating neurotransmitter release at the neuromuscular junctions [41], we were unable to assess olfactory behaviors in this genetic background.	This sentence does not contain fully or partially curatable data, or terms related to the datatype.	This sentence is not fully or partially curatable, but it contains terms related to the datatype.
age-1 mutation further reduces the glycogen content in atgl-1(xd314) embryos.	This sentence does not contain fully or partially curatable data, or terms related to the datatype.	This sentence does not contain fully or partially curatable data, or terms related to the datatype.
Indeed, genetic rescue of flr-2 under the control of a pan-neuronal promoter partially reverses the growth and body size phenotypes of the drl-1; flr-2 double mutants (S6C and S6D Fig), suggesting that expression of flr-2 in neurons is sufficient to slow the growth of drl-1 mutant animals.	This sentence is not fully or partially curatable, but it contains terms related to the datatype.	This sentence is not fully or partially curatable, but it contains terms related to the datatype.
Multiple kinases act together to bring about these changes and ensure that the duplicated genome is equally partitioned to the daughter cells post-mitosis.	This sentence does not contain fully or partially curatable data, or terms related to the datatype.	This sentence does not contain fully or partially curatable data, or terms related to the datatype.
The transcription of Btbd9 in Meis1 KO and the level of Meis1 protein in Btbd9 KO animals were studied.	This sentence is not fully or partially curatable, but it contains terms related to the datatype.	This sentence is not fully or partially curatable, but it contains terms related to the datatype.
S. aureus can readily develop resistance against most clinical antibacterial agents (35).	This sentence does not contain fully or partially curatable data, or terms related to the datatype.	This sentence does not contain fully or partially curatable data, or terms related to the datatype.
Ectopic AC expression of the second central hox gene mab-5 and, to a lesser extent, the posterior hox gene egl-5 likewise triggered AC proliferation.	This sentence is not fully or partially curatable, but it contains terms related to the datatype.	This sentence is not fully or partially curatable, but it contains terms related to the datatype.
Then, we tested whether the photosensitizer could be properly taken up by the bacterial cells.	This sentence does not contain fully or partially curatable data, or terms related to the datatype.	This sentence does not contain fully or partially curatable data, or terms related to the datatype.
It remains unclear how CRTC-1 CBD regulates histone acetylation.	This sentence does not contain fully or partially curatable data, or terms related to the datatype.	This sentence does not contain fully or partially curatable data, or terms related to the datatype.
The RabGAP TBC-3 acts in the endosome-to-Golgi trafficking pathway	This sentence only contains partially curatable data.	This sentence does not contain fully or partially curatable data, or terms related to the datatype.
We expressed a functional (see Fig 1E) tagrfp-tagged ric-8 cDNA (isoform a) under the bbs-8 or ceh-36Δ promoters, which are transcriptionally active in all ciliated neurons or AWC, respectively [58], and observed RIC-8::TagRFP localization throughout ciliated sensory neurons including cilia.	This sentence only contains fully curatable data.	This sentence only contains fully curatable data.
Taken together, these data suggest that inx-14 and glp-1 function in the same genetic pathway, and glp-1 may genetically act downstream of inx-14 to suppress intestinal defense.	This sentence is not fully or partially curatable, but it contains terms related to the datatype.	This sentence does not contain fully or partially curatable data, or terms related to the datatype.
Untargeted Chemical Screening of the Extractable Additive Solution.	This sentence does not contain fully or partially curatable data, or terms related to the datatype.	This sentence does not contain fully or partially curatable data, or terms related to the datatype.
For specific rescue transgenes of inx-14(ag17), the plasmid DNA of pXZ20 (Ppgl-1::inx-14::SL2::GFP::unc-54 3' UTR), or pXZ23 (Pges-1::inx-14::SL2::GFP::unc-54 3' UTR) was injected at 20 ng ml -1 with co-injection marker at 5 ng ml -1 , and 1 kb ladder up to 100 ng ml -1 .	This sentence is not fully or partially curatable, but it contains terms related to the datatype.	This sentence is not fully or partially curatable, but it contains terms related to the datatype.
To test this hypothesis, we induced a conditional knock-down of lin-39 at the late L2/early L3 stage after the VPC fates have been specified but before the first round of cell division took place.	This sentence does not contain fully or partially curatable data, or terms related to the datatype.	This sentence does not contain fully or partially curatable data, or terms related to the datatype.
Intestinal DVE-1::AID::wrmScarlet was not significantly affected (Fig. 2c,d), demonstrating that degradation was specific to TIR1 expressing cells.	This sentence is not fully or partially curatable, but it contains terms related to the datatype.	This sentence is not fully or partially curatable, but it contains terms related to the datatype.
The atgl-1 mutation leads to increased neutral lipid content and reduced glycogen content in embryos.	This sentence does not contain fully or partially curatable data, or terms related to the datatype.	This sentence does not contain fully or partially curatable data, or terms related to the datatype.
RNAi clones were obtained from the Ahringer library (GeneService), except for clones for rab-19, rab-27, rab-30 and C56E6.2, which were obtained from the Vidal library (Open Biosystems).	This sentence does not contain fully or partially curatable data, or terms related to the datatype.	This sentence does not contain fully or partially curatable data, or terms related to the datatype.
As a negative control, a pbx-ACELp>nls::gfp transgene was used (Fig. 4A).	This sentence is not fully or partially curatable, but it contains terms related to the datatype.	This sentence is not fully or partially curatable, but it contains terms related to the datatype.
3 washes were done with dilution buffer followed by addition of 80 ml 2x SDS dye.	This sentence does not contain fully or partially curatable data, or terms related to the datatype.	This sentence does not contain fully or partially curatable data, or terms related to the datatype.
Purification was done using Ni-NTA (Qiagen: 30230) beads using gravity column, using binding buffer (8M Urea, 50mM Tris-HCl pH 8.0, 500mM NaCl, 20mM imidazole and 1 mM 2-mercaptoethanol).	This sentence does not contain fully or partially curatable data, or terms related to the datatype.	This sentence does not contain fully or partially curatable data, or terms related to the datatype.
To obtain other synchronized stages, the synchronized L1s are plated on solid agar substrate with E. coli food and allowed to progress to the desired stage before processing.	This sentence does not contain fully or partially curatable data, or terms related to the datatype.	This sentence does not contain fully or partially curatable data, or terms related to the datatype.
By shrinking the cell size to the scale of the wavelength and employing a fast rotation stage, spatial modulation at megahertz rates is demonstrated for images with up to 25,111 pixels and image-pixel size down to 2 µm.	This sentence does not contain fully or partially curatable data, or terms related to the datatype.	This sentence does not contain fully or partially curatable data, or terms related to the datatype.
An example is a report of the sumoylation of the human TGFb Type I receptor Alk-5 (also known as TBRI [Kang et al. 2008]).	This sentence does not contain fully or partially curatable data, or terms related to the datatype.	This sentence does not contain fully or partially curatable data, or terms related to the datatype.
After normalizing the expression values, we used a t-test with a >2-fold change threshold to identify significantly differentially-expressed genes.	This sentence is not fully or partially curatable, but it contains terms related to the datatype.	This sentence is not fully or partially curatable, but it contains terms related to the datatype.
Furrow-flanking rows are the most consistent in puncta size and spacing and are prefigured as diffuse bands in the L4 stage cuticle furrows, suggesting furrows are important in organization and/ or secretion of strut material.	This sentence does not contain fully or partially curatable data, or terms related to the datatype.	This sentence does not contain fully or partially curatable data, or terms related to the datatype.
Finally, INX-14/GLP-1 signalingdependent intestine defense is dependent on PMK-1/p38 but not insulin/IGF-like receptor signaling.	This sentence does not contain fully or partially curatable data, or terms related to the datatype.	This sentence does not contain fully or partially curatable data, or terms related to the datatype.
However, their roles in intestinal innate immunity remain unclear.	This sentence does not contain fully or partially curatable data, or terms related to the datatype.	This sentence does not contain fully or partially curatable data, or terms related to the datatype.
Strikingly, there was no difference in AWB cilia length or membranous fan width between wild type and ric-8(md303) mutant L1 larvae (Fig 1B and 1C and S3 Table), suggesting that ric-8 functions during post-embryonic stages to promote expansion of ciliary membrane in winged neurons.	This sentence is not fully or partially curatable, but it contains terms related to the datatype.	This sentence does not contain fully or partially curatable data, or terms related to the datatype.
Resulting L1s were grown on 10 cm plates, with 10,000 L1s per plate, and incubated at room temperature for 48 hours.	This sentence does not contain fully or partially curatable data, or terms related to the datatype.	This sentence does not contain fully or partially curatable data, or terms related to the datatype.
Therefore, an energy deficit may underlie the embryonic lethality of atgl-1(xd314) mutants and contribute to the incompletely penetrant phenotype.	This sentence does not contain fully or partially curatable data, or terms related to the datatype.	This sentence does not contain fully or partially curatable data, or terms related to the datatype.
To determine whether RIC-8 regulates levels of Gα ODR-3 in AWC neurons, and thus functions as an ODR-3 chaperone, we examined localization of the internally tagged ODR-3 FL :: TagRFP fusion protein in cilia, distal dendrites, and cell bodies of wild-type and ric-8(md1909) mutant animals.	This sentence only contains partially curatable data.	This sentence is not fully or partially curatable, but it contains terms related to the datatype.
These data explain why drl-1 and flr-4 mutants have similar phenotypes and provide a mechanistic basis for their role in maintaining intestinal homeostasis via MAPK signaling.	This sentence does not contain fully or partially curatable data, or terms related to the datatype.	This sentence does not contain fully or partially curatable data, or terms related to the datatype.
We show that three collagens BLI-1, BLI-2, and BLI-6, play critical roles in strut formation.	This sentence does not contain fully or partially curatable data, or terms related to the datatype.	This sentence does not contain fully or partially curatable data, or terms related to the datatype.
Our findings may be used for further mechanistic investigations concerning the metabolic diseases associated with mitochondrial mutations.	This sentence does not contain fully or partially curatable data, or terms related to the datatype.	This sentence does not contain fully or partially curatable data, or terms related to the datatype.
In order to solve this problem, the researchers are more committed to the following two aspects to improve the accuracy of the prediction results.	This sentence does not contain fully or partially curatable data, or terms related to the datatype.	This sentence does not contain fully or partially curatable data, or terms related to the datatype.
RNA-Seq analyses revealed that germline-specific inx-14 RNAi downregulated Notch/GLP-1 signaling, while lysosome and PMK-1/p38 pathways were upregulated.	This sentence is not fully or partially curatable, but it contains terms related to the datatype.	This sentence is not fully or partially curatable, but it contains terms related to the datatype.
c, Over-representation analysis of the Gene Ontology biological process terms for genes comprising all comparisons from the RNA-Seq samples: wild-type, set-2, crtc-1 CBD-/-, and crtc-1 CBD-/-;set-2 strains.	This sentence does not contain fully or partially curatable data, or terms related to the datatype.	This sentence is not fully or partially curatable, but it contains terms related to the datatype.
Identification of candidate suppressor mutations was performed as previously described [79] using in-house scripts.	This sentence does not contain fully or partially curatable data, or terms related to the datatype.	This sentence does not contain fully or partially curatable data, or terms related to the datatype.
In order to avoid this, gas in the tank is removed with a vacuum cleaner, and the wall is wiped with a paper towel containing EtOH, followed by further suction with the vacuum cleaner.	This sentence does not contain fully or partially curatable data, or terms related to the datatype.	This sentence does not contain fully or partially curatable data, or terms related to the datatype.
In addition, we have proposed an integrated algorithm to generate informative features.	This sentence does not contain fully or partially curatable data, or terms related to the datatype.	This sentence does not contain fully or partially curatable data, or terms related to the datatype.
Furthermore, the worm and human share 12 of 17 signal transduction pathways [21,22].	This sentence does not contain fully or partially curatable data, or terms related to the datatype.	This sentence does not contain fully or partially curatable data, or terms related to the datatype.
Xu et al. [27] selected the isoelectric point (PI) properties of amino acids for analysis, and the experimental results show that this physicochemical property has an important influence on the polypeptide chain.	This sentence does not contain fully or partially curatable data, or terms related to the datatype.	This sentence does not contain fully or partially curatable data, or terms related to the datatype.
Therefore, mab-5 and egl-5 may also be able to induce AC proliferation, either directly or indirectly through activation of endogenous lin-39 expression.	This sentence is not fully or partially curatable, but it contains terms related to the datatype.	This sentence is not fully or partially curatable, but it contains terms related to the datatype.
Shen et al. [17] proposed a method for PPI prediction using only the amino acid sequence information of proteins.	This sentence does not contain fully or partially curatable data, or terms related to the datatype.	This sentence does not contain fully or partially curatable data, or terms related to the datatype.
Moreover, other genetic perturbations that induce p38 hyperactivation include mutations in the neuronal developmental regulator olrn-1 or the intestinal pseudokinase nipi-3 [40,42,44]; however, knockdown of fshr-1 failed to suppress the body size defects caused by the olrn-1 or nipi-3 mutations, indicating that these pathways function independently of fshr-1 (Fig 7E).	This sentence does not contain fully or partially curatable data, or terms related to the datatype.	This sentence does not contain fully or partially curatable data, or terms related to the datatype.
We next performed an RNAi screen targeting C. elegans rab genes, but no suppressor of tbc-3 was identified (Table S1).	This sentence does not contain fully or partially curatable data, or terms related to the datatype.	This sentence does not contain fully or partially curatable data, or terms related to the datatype.
None of the heat-shocked transgenic animals carrying untagged N-and C-terminal Venus fragments expressed from the AWC-specific and heat-shock promoters, respectively, showed fluorescence complementation (Fig 4D and4E).	This sentence only contains partially curatable data.	This sentence is not fully or partially curatable, but it contains terms related to the datatype.
The experiment used a three-fold cross-validation.	This sentence does not contain fully or partially curatable data, or terms related to the datatype.	This sentence does not contain fully or partially curatable data, or terms related to the datatype.
The guide sequence and the tra-crRNA were placed downstream of the U6 promoter using overlapping PCR (Ward, 2015).	This sentence does not contain fully or partially curatable data, or terms related to the datatype.	This sentence does not contain fully or partially curatable data, or terms related to the datatype.
In the early stages of development, the embryos mainly utilize glycogen; then, when the embryos are composed of dozens of cells, they start to mobilize neutral lipids.	This sentence does not contain fully or partially curatable data, or terms related to the datatype.	This sentence does not contain fully or partially curatable data, or terms related to the datatype.
In contrast null mutants in bli-6 cause subtle effects on cuticle morphology and accelerate the onset of blistering in bli-1 or bli-2 null mutants, suggesting BLI-6 may function separately from BLI-1 or BLI-2.	This sentence does not contain fully or partially curatable data, or terms related to the datatype.	This sentence does not contain fully or partially curatable data, or terms related to the datatype.
However, currently, little is known about the effects of such additives on the soil environment.	This sentence does not contain fully or partially curatable data, or terms related to the datatype.	This sentence does not contain fully or partially curatable data, or terms related to the datatype.
Similarly, in the MRSA infection model (Fig. 7), compared with the vehicle control group, MRSA-infected worms showed significant growth retardation.	This sentence does not contain fully or partially curatable data, or terms related to the datatype.	This sentence does not contain fully or partially curatable data, or terms related to the datatype.
The L-rhamnose conjugated biomolecules critical for cuticle integrity remain to be identified and investigated.	This sentence does not contain fully or partially curatable data, or terms related to the datatype.	This sentence does not contain fully or partially curatable data, or terms related to the datatype.
To examine which signaling pathways are required for INX-14-mediated intestinal defense, we knocked down the expression of essential components of these pathways using RNAi in an inx-14(ag17) mutant background and compared their survival on PA14 bacteria.	This sentence does not contain fully or partially curatable data, or terms related to the datatype.	This sentence is not fully or partially curatable, but it contains terms related to the datatype.
For example, bisphenol A, which is authorized under Registration, Evaluation, Authorisation and Restriction of Chemicals (REACH) as a stabilizer, is regarded as an estrogen agonist. 38	This sentence does not contain fully or partially curatable data, or terms related to the datatype.	This sentence does not contain fully or partially curatable data, or terms related to the datatype.
To determine if TBC-3 is involved in systemic RNAi as a RabGAP, we expressed a catalytically inactivated form of TBC-3b (RQ-AA) in tbc-3(tm9833) animals.	This sentence is not fully or partially curatable, but it contains terms related to the datatype.	This sentence is not fully or partially curatable, but it contains terms related to the datatype.
These mutants have their distinct influences on the worm, depending on the mutations.	This sentence does not contain fully or partially curatable data, or terms related to the datatype.	This sentence does not contain fully or partially curatable data, or terms related to the datatype.
The development of a single-celled fertilized egg into a multicellular adult is an essential part of all animal life cycles.	This sentence does not contain fully or partially curatable data, or terms related to the datatype.	This sentence does not contain fully or partially curatable data, or terms related to the datatype.
Worm genomic DNA was prepared for sequencing using Gentra Puregene Tissue Kit DNA purification (Qiagen).	This sentence does not contain fully or partially curatable data, or terms related to the datatype.	This sentence does not contain fully or partially curatable data, or terms related to the datatype.
Currently, when using the machine learning to predict the PPIs, the methods always combine the two sequences of the protein together as the input [12,13].	This sentence does not contain fully or partially curatable data, or terms related to the datatype.	This sentence does not contain fully or partially curatable data, or terms related to the datatype.
To map the chromosomal location of the suppressor mutation, we used the single nucleotide polymorphism mapping (SNP) method as previously described (Davis et al, 2005).	This sentence does not contain fully or partially curatable data, or terms related to the datatype.	This sentence does not contain fully or partially curatable data, or terms related to the datatype.
For each worm, fluorescence intensity was determined by subtracting the background mean gray value (MGV) from MGV of the procorpus.	This sentence is not fully or partially curatable, but it contains terms related to the datatype.	This sentence is not fully or partially curatable, but it contains terms related to the datatype.
For some of these points, we can conceive of different explanations that would account for the observations under a drug-pump model, but these explanations are non-parsimonious.	This sentence does not contain fully or partially curatable data, or terms related to the datatype.	This sentence does not contain fully or partially curatable data, or terms related to the datatype.
BLI-2 and BLI-6 collagens are typical nematode cuticle collagens, whereas BLI-1 is unusually large with extended N-and C-terminal domains that are conserved in other nematodes of the Caenorhabditis genus (Fig. S1).	This sentence does not contain fully or partially curatable data, or terms related to the datatype.	This sentence does not contain fully or partially curatable data, or terms related to the datatype.
ns, no significant difference from the vehicle control.	This sentence does not contain fully or partially curatable data, or terms related to the datatype.	This sentence does not contain fully or partially curatable data, or terms related to the datatype.
We noted wild-type animals without stimulus rarely make angles >50˚and qualified any bending angle over 50°as a deep bend.	This sentence does not contain fully or partially curatable data, or terms related to the datatype.	This sentence does not contain fully or partially curatable data, or terms related to the datatype.
Our data suggests that PGP-14 pumps polar lipids into the developing cuticle in a manner that is dependent on a plasma membrane rich in sphingomyelin.	This sentence does not contain fully or partially curatable data, or terms related to the datatype.	This sentence is not fully or partially curatable, but it contains terms related to the datatype.
Fluorescence was measured at room temperature using a spectrophotometer (SpectraMax M2; Molecular Devices) at the excitation of 485 nm and the emission of 525 nm.	This sentence does not contain fully or partially curatable data, or terms related to the datatype.	This sentence does not contain fully or partially curatable data, or terms related to the datatype.
One possible route for temporal regulation might be through control of DVE-1 nuclear localization.	This sentence is not fully or partially curatable, but it contains terms related to the datatype.	This sentence is not fully or partially curatable, but it contains terms related to the datatype.
Our biochemical data have not shown clear evidence of maturation of strut components such as a transition from monomeric to higher molecular weight forms, however our analyses are restricted to the soluble cuticle fraction and so may not address insoluble matrix structures.	This sentence does not contain fully or partially curatable data, or terms related to the datatype.	This sentence does not contain fully or partially curatable data, or terms related to the datatype.
Consistently, overexpression of drl-1 on an extrachromosomal array is sufficient to suppress the growth rate defects induced by simultaneous loss of both drl-1 and flr-4 (S3D Fig) , suggesting that DRL-1, and its potential kinase activity, can compensate for loss of flr-4.	This sentence is not fully or partially curatable, but it contains terms related to the datatype.	This sentence is not fully or partially curatable, but it contains terms related to the datatype.
Hence, no proliferation of somatic cells occurs in adult animals.	This sentence does not contain fully or partially curatable data, or terms related to the datatype.	This sentence does not contain fully or partially curatable data, or terms related to the datatype.
Both snx-3(tm1595); tbc-3(tm9833) and tbc-3(tm9920) mon2(tm2605) double mutants showed partial resistance to feeding RNAi comparable to tbc-3 single mutants (Figure 7B).	This sentence does not contain fully or partially curatable data, or terms related to the datatype.	This sentence does not contain fully or partially curatable data, or terms related to the datatype.
Our results showed that GFP-labeled PA14 bacteria (PA14::GFP) accumulated less in the intestine of inx-14(ag17) mutants compared to wild-type.	This sentence is not fully or partially curatable, but it contains terms related to the datatype.	This sentence does not contain fully or partially curatable data, or terms related to the datatype.
Our 4mcDeep-CBI model shows the best predictive performance, and we achieve ACC = 0.9294, MCC = 0.8498, SN = 0.9486, SP = 0.8938, AUC = 0.9242.	This sentence does not contain fully or partially curatable data, or terms related to the datatype.	This sentence does not contain fully or partially curatable data, or terms related to the datatype.
However, age-1 mutation did not significantly reduce the high embryonic lipid levels caused by atgl-1 mutation (Fig 5A).	This sentence does not contain fully or partially curatable data, or terms related to the datatype.	This sentence does not contain fully or partially curatable data, or terms related to the datatype.
Taking the surface area of an adult C. elegans as approximately 5 × 10 5 μm 2 , we estimate there are ~10 6 struts in a typical adult cuticle.	This sentence does not contain fully or partially curatable data, or terms related to the datatype.	This sentence does not contain fully or partially curatable data, or terms related to the datatype.
Next, we assessed the impact of LMN-1 depletion on NEBD in control or B55  ts embryos expressing NPP-1-GFP.	This sentence is not fully or partially curatable, but it contains terms related to the datatype.	This sentence is not fully or partially curatable, but it contains terms related to the datatype.
RNAi exposure was performed according to the standard procedure (Kamath & Ahringer, 2003).	This sentence does not contain fully or partially curatable data, or terms related to the datatype.	This sentence does not contain fully or partially curatable data, or terms related to the datatype.
This indicates that this difference in LPS structure is insufficient to affect oocyte development.	This sentence does not contain fully or partially curatable data, or terms related to the datatype.	This sentence does not contain fully or partially curatable data, or terms related to the datatype.
Dry YPs were mixed with water (180 g YP/L) and the slurry was passed through an Emulsiflex ® -C3 high-pressure homogenizer (Avestin, Ottawa, ON, USA) to obtain a uniform single YP suspension.	This sentence does not contain fully or partially curatable data, or terms related to the datatype.	This sentence does not contain fully or partially curatable data, or terms related to the datatype.
To test the membrane selectivity of PQ401, we fabricated GUVs consisting of 1-palmitoyl-2-oleoyl-glycero-3-phosphocholine (POPC) and cholesterol in the ratio of 7:3, which mimics mammalian lipid bilayers (50,51).	This sentence does not contain fully or partially curatable data, or terms related to the datatype.	This sentence does not contain fully or partially curatable data, or terms related to the datatype.
In contrast to well-studied membrane-disrupting cationic antimicrobial low-molecular-weight compounds and peptides, molecular dynamic simulations supported by efficacy data demonstrate that the neutral form of PQ401 penetrates and subsequently embeds into bacterial lipid bilayers more effectively than the cationic form.	This sentence does not contain fully or partially curatable data, or terms related to the datatype.	This sentence does not contain fully or partially curatable data, or terms related to the datatype.
Further, depletion of CBP-1, MYS-1/TRR-1 and HDA-6 is associated with immune response and stress resistance 34,48,49 .	This sentence does not contain fully or partially curatable data, or terms related to the datatype.	This sentence does not contain fully or partially curatable data, or terms related to the datatype.
pgp-14 and sms-5 were identified in the same genetic screen for mutants that can resist crystal-associated death.	This sentence does not contain fully or partially curatable data, or terms related to the datatype.	This sentence does not contain fully or partially curatable data, or terms related to the datatype.
The sensory system is an important interface between the environment and an animal's physiology, which suggests a role for the sensory system in germline biology.	This sentence does not contain fully or partially curatable data, or terms related to the datatype.	This sentence does not contain fully or partially curatable data, or terms related to the datatype.
In the future, it will be crucial to define the metabolic role of FSH signaling in mammalian non-reproductive tissues, including the liver and adipose tissue, as well as assess whether MAPK signaling impinges on these pathways to integrate metabolic and developmental programs.	This sentence does not contain fully or partially curatable data, or terms related to the datatype.	This sentence does not contain fully or partially curatable data, or terms related to the datatype.
Thus, it is difficult to make predictions but a conserved lysine in an intracellular loop that may be enzymatically accessible suggests that posttranslational modification is a possibility.	This sentence does not contain fully or partially curatable data, or terms related to the datatype.	This sentence does not contain fully or partially curatable data, or terms related to the datatype.
Supporting these data, our IP experiments confirm that CRTC-1 interacts with the C. elegans counterpart of Sec31A, SEC-31	This sentence does not contain fully or partially curatable data, or terms related to the datatype.	This sentence does not contain fully or partially curatable data, or terms related to the datatype.
Effects of Additive-Extracted Microplastics.	This sentence does not contain fully or partially curatable data, or terms related to the datatype.	This sentence does not contain fully or partially curatable data, or terms related to the datatype.
"To achieve this, we generated three transgenes delivering different dosages of lin-39; one transgene expressing lin-39::gfp under control of the ACEL promotor without the distal egl-17 enhancer (ACELp>lin-39::gfp), a second containing a truncated, 50 bp distal egl-17 enhancer (short pbx-ACELp>lin-39::gfp) and a third with the full-length 161 bp distal egl-17p enhancer re-inserted at the 5' end (long pbx-ACELp>lin-39::gfp) (Supplementary Fig. 4D-D"")."	This sentence is not fully or partially curatable, but it contains terms related to the datatype.	This sentence is not fully or partially curatable, but it contains terms related to the datatype.
Finally, we evaluated our proposed 4mcDeep-CBI with the state-ofart predictor, and the results demonstrate that our model can achieve better performance in identifying 4mC sites and runs more efficiently.	This sentence does not contain fully or partially curatable data, or terms related to the datatype.	This sentence does not contain fully or partially curatable data, or terms related to the datatype.
Thus of the three collagens localizing to struts, only BLI-1 appears specific to struts whereas BLI-2 and BLI-6 localize to additional matrix substructures independent of BLI-1.	This sentence only contains partially curatable data.	This sentence only contains partially curatable data.
While neuron-extrinsic events that shape remodeling, for example, microglial phagocytosis of synaptic material [5][6][7][8] , have gained a lot of recent attention, neuron-intrinsic processes governing remodeling have remained less well-described.	This sentence does not contain fully or partially curatable data, or terms related to the datatype.	This sentence does not contain fully or partially curatable data, or terms related to the datatype.
Each point represents a single animal.	This sentence does not contain fully or partially curatable data, or terms related to the datatype.	This sentence does not contain fully or partially curatable data, or terms related to the datatype.
However, if there is no 8-min interval (e.g., 1, 2, 3, and 4 min for 0.04 and 0.12 μM), clean the tank (see the next section) and start from the gas vaporization.	This sentence does not contain fully or partially curatable data, or terms related to the datatype.	This sentence does not contain fully or partially curatable data, or terms related to the datatype.
Our work is focused on chemicals leaching and on the concept of K D to better understand the ecotoxicity of microplastics.	This sentence does not contain fully or partially curatable data, or terms related to the datatype.	This sentence does not contain fully or partially curatable data, or terms related to the datatype.
Conventional confocal; insets 10 μm wide.	This sentence does not contain fully or partially curatable data, or terms related to the datatype.	This sentence does not contain fully or partially curatable data, or terms related to the datatype.
Comparisons between two or more groups were performed using one-way or two-way analysis of variance (ANOVA) with Tukey's correction for multiple comparisons.	This sentence does not contain fully or partially curatable data, or terms related to the datatype.	This sentence does not contain fully or partially curatable data, or terms related to the datatype.
YP-terpene activity against N. brasiliensis: After testing the terpenes on A. ceylanicum and T. muris, we screened selected YP-terpenes on N. brasiliensis (Figure 4).	This sentence does not contain fully or partially curatable data, or terms related to the datatype.	This sentence does not contain fully or partially curatable data, or terms related to the datatype.
In contrast, blistering in the bli-1(0); bli-6(ju1681) double mutant was intermediate by 3 h post-molt and progressed to severe by 5 h post-molt; blisters were also larger in double mutants at 24 and 48 h post-molt (Fig. 6a).	This sentence does not contain fully or partially curatable data, or terms related to the datatype.	This sentence does not contain fully or partially curatable data, or terms related to the datatype.
Since DVE-1 expression is limited to postsynaptic GABAergic neurons, our results suggest that DVE-1-regulated postsynaptic pathways promote the exchange or elimination of juvenile presynaptic elements through destabilization of the postsynaptic apparatus and associated signaling components.	This sentence only contains fully curatable data.	This sentence is not fully or partially curatable, but it contains terms related to the datatype.
The exact p-values for all survival assay are listed in Supporting Table S1.	This sentence does not contain fully or partially curatable data, or terms related to the datatype.	This sentence does not contain fully or partially curatable data, or terms related to the datatype.
These data suggest that, while CRTC-1 CBD domain is necessary for both the longevity and MUFA accumulation phenotypes of set-2 mutant worms, these two pathways appear to be decoupled in the context of CRTC-1.	This sentence does not contain fully or partially curatable data, or terms related to the datatype.	This sentence does not contain fully or partially curatable data, or terms related to the datatype.
Thus, loss of ASJ delayed oogenesis based on the temporal expression of the two oogenesis reporters, lin-41::GFP and oma-1::GFP.	This sentence is not fully or partially curatable, but it contains terms related to the datatype.	This sentence is not fully or partially curatable, but it contains terms related to the datatype.
Farnesol was still effective at low doses at the 24-h time point.	This sentence does not contain fully or partially curatable data, or terms related to the datatype.	This sentence does not contain fully or partially curatable data, or terms related to the datatype.
Earlier work has demonstrated that NEP occurs in two phases.	This sentence does not contain fully or partially curatable data, or terms related to the datatype.	This sentence does not contain fully or partially curatable data, or terms related to the datatype.
In this paper, the Dmeyer wavelet function is used in the discrete wavelet transform part, and Dmeyer is the discrete Meyer wavelet, which is used for the calculation of fast discrete wavelet transform.	This sentence does not contain fully or partially curatable data, or terms related to the datatype.	This sentence does not contain fully or partially curatable data, or terms related to the datatype.
Expression of SID-5 in the intestine is required for RNAi silencing in the body wall muscles upon dsRNA ingestion, suggesting a possible function of SID-5 in dsRNA export out of cells. 19	This sentence is not fully or partially curatable, but it contains terms related to the datatype.	This sentence is not fully or partially curatable, but it contains terms related to the datatype.
8. Please provide all the original Western blot figures in the supplemental data.	This sentence does not contain fully or partially curatable data, or terms related to the datatype.	This sentence does not contain fully or partially curatable data, or terms related to the datatype.
Biological experiments are laborious and expensive when performing genome-wide testing.	This sentence does not contain fully or partially curatable data, or terms related to the datatype.	This sentence does not contain fully or partially curatable data, or terms related to the datatype.
To further explore the validity of the model, we used the same method to conduct experiments on different species datasets.	This sentence does not contain fully or partially curatable data, or terms related to the datatype.	This sentence does not contain fully or partially curatable data, or terms related to the datatype.
In agreement with the above-mentioned studies on generic chaotic systems, our results indicate that the network can indeed respond consistently to repeated presentations of the same complex (irregular) sequence of events, even though the individual responses to single events across the sequence are highly variable.	This sentence does not contain fully or partially curatable data, or terms related to the datatype.	This sentence does not contain fully or partially curatable data, or terms related to the datatype.
N. brasiliensis were maintained in Wistar rats [41].	This sentence does not contain fully or partially curatable data, or terms related to the datatype.	This sentence does not contain fully or partially curatable data, or terms related to the datatype.
The neural network model of local weight sharing is shown as Figure 1.	This sentence does not contain fully or partially curatable data, or terms related to the datatype.	This sentence does not contain fully or partially curatable data, or terms related to the datatype.
(2) There are two important parameters (the penalty parameter C and the kernel parameter γ ) in the SVM model used by 4mcPred-IFL.	This sentence does not contain fully or partially curatable data, or terms related to the datatype.	This sentence does not contain fully or partially curatable data, or terms related to the datatype.
For light exposure, 100 μl samples were irradiated from the top of a transparent 96-well plate (SPL Life Science, Pocheon, Korea).	This sentence does not contain fully or partially curatable data, or terms related to the datatype.	This sentence does not contain fully or partially curatable data, or terms related to the datatype.
Additionally, hpo-9(tm3719) treated with unc-62 RNAi retained a similar number of eggs as N2.	This sentence does not contain fully or partially curatable data, or terms related to the datatype.	This sentence does not contain fully or partially curatable data, or terms related to the datatype.
The experiment on the effects of extractable additive solutions also showed differential toxicity among different PP fragment sizes.	This sentence does not contain fully or partially curatable data, or terms related to the datatype.	This sentence does not contain fully or partially curatable data, or terms related to the datatype.
Development of resistant mutants by serial passage was conducted as previously described (36).	This sentence does not contain fully or partially curatable data, or terms related to the datatype.	This sentence does not contain fully or partially curatable data, or terms related to the datatype.
Co-Smads contain two conserved lysines including the universal Smad lysine in the MH2 domain.	This sentence does not contain fully or partially curatable data, or terms related to the datatype.	This sentence does not contain fully or partially curatable data, or terms related to the datatype.
The evaluation criteria for the algorithm use several widely used parameters: accuracy, recall, specificity, precision, and MCC (Mathew's correlation coefficient).	This sentence does not contain fully or partially curatable data, or terms related to the datatype.	This sentence does not contain fully or partially curatable data, or terms related to the datatype.
After adding 15 young adult C. elegans glp-4(bn2);sek-1(km4) animals to each well of the plate using a COPAS large particle sorter (Union Biometrica, MA, USA), 35 l of MRSA MW2 suspension was added (OD 600 , 0.08).	This sentence does not contain fully or partially curatable data, or terms related to the datatype.	This sentence does not contain fully or partially curatable data, or terms related to the datatype.
The initial condition is chosen randomly for each neuron, uniformly distributed between -1 and 1.	This sentence does not contain fully or partially curatable data, or terms related to the datatype.	This sentence does not contain fully or partially curatable data, or terms related to the datatype.
Advances in in vivo calcium imaging have recently allowed monitoring the dynamical activity of tens of neurons in free-moving C. elegans worms under controlled thermosensory conditions. 27	This sentence does not contain fully or partially curatable data, or terms related to the datatype.	This sentence does not contain fully or partially curatable data, or terms related to the datatype.
[10][11] Previous studies have reported that 8-67 500 mg/kg microplastics can be observed in industrial, 12 pristine floodplain, 13 and agricultural lands. 14	This sentence does not contain fully or partially curatable data, or terms related to the datatype.	This sentence does not contain fully or partially curatable data, or terms related to the datatype.
Single-molecule real-time sequencing (SMRT) technology can detect 4mC, 5mc, and 6mA base modifications (Ecker, 2010;Flusberg et al., 2010;Clark et al., 2013;Davis et al., 2013).	This sentence does not contain fully or partially curatable data, or terms related to the datatype.	This sentence does not contain fully or partially curatable data, or terms related to the datatype.
The change may reduce ATP synthesis by TCA cycles, and it would be supplemented by glycolytic ATP production [18].	This sentence does not contain fully or partially curatable data, or terms related to the datatype.	This sentence does not contain fully or partially curatable data, or terms related to the datatype.
L-carvone has a similar solubility in water as carvacrol, but it shows a slower rate of release from YPs (40-60% at 3 h) and almost complete terpene release at 24 h.	This sentence does not contain fully or partially curatable data, or terms related to the datatype.	This sentence does not contain fully or partially curatable data, or terms related to the datatype.
Each microplastic (118.4 mg) was added to a 10 mL glass vial containing 5 g of glass beads, and they were gently mixed using a spatula.	This sentence does not contain fully or partially curatable data, or terms related to the datatype.	This sentence does not contain fully or partially curatable data, or terms related to the datatype.
At the most general level, phylogenetic biochemistry can be employed to predict posttranslational modification of lysines in any conserved protein family.	This sentence does not contain fully or partially curatable data, or terms related to the datatype.	This sentence does not contain fully or partially curatable data, or terms related to the datatype.
In this study, we focused on these representative skin pathogens, including gram-positive and gramnegative bacteria and fungi.	This sentence does not contain fully or partially curatable data, or terms related to the datatype.	This sentence does not contain fully or partially curatable data, or terms related to the datatype.
During the analysis we determined that the Wnt pathway might be slightly older than the TGFb pathway.	This sentence does not contain fully or partially curatable data, or terms related to the datatype.	This sentence does not contain fully or partially curatable data, or terms related to the datatype.
A high loading capacity (1.1:1 w/w payload:YP) was achieved with all twenty target materials.	This sentence does not contain fully or partially curatable data, or terms related to the datatype.	This sentence does not contain fully or partially curatable data, or terms related to the datatype.
It was further extended to DNA representation and introduced several predictors, namely repDNA (Li et al. 2015), Pse-in-One (YongE and GaoShan 2015), and iDNA-KACC (Xiang et al. 2016).	This sentence does not contain fully or partially curatable data, or terms related to the datatype.	This sentence does not contain fully or partially curatable data, or terms related to the datatype.
Imaging was performed with rectangular illumination patterns with 101 × 103 (N = 10,403) pixels, where the imaging speed was 72 frames per second (fps).	This sentence does not contain fully or partially curatable data, or terms related to the datatype.	This sentence does not contain fully or partially curatable data, or terms related to the datatype.
These large doses are also associated with toxic side effects, including mucosal irritation and nausea [24,25].	This sentence does not contain fully or partially curatable data, or terms related to the datatype.	This sentence does not contain fully or partially curatable data, or terms related to the datatype.
Lastly, we did not observe any anthelmintic activity with alpha-terpineol, linalool, anethole, peppermint oil, lavender oil, or tea tree oil against T. muris.	This sentence does not contain fully or partially curatable data, or terms related to the datatype.	This sentence does not contain fully or partially curatable data, or terms related to the datatype.
Lys 347 in Dm Wit occurs in a nonconserved region.	This sentence does not contain fully or partially curatable data, or terms related to the datatype.	This sentence does not contain fully or partially curatable data, or terms related to the datatype.
The time step was 2 fs.	This sentence does not contain fully or partially curatable data, or terms related to the datatype.	This sentence does not contain fully or partially curatable data, or terms related to the datatype.
Initially, on the basis of singlet oxygen generation from potential natural products, screening was conducted to discover an active photosensitizer for APDT, which led to the finding that TWE could generate 1 O 2 under irradiation with several LED conditions.	This sentence does not contain fully or partially curatable data, or terms related to the datatype.	This sentence does not contain fully or partially curatable data, or terms related to the datatype.
Agar, bacto-peptone, and LB broth were obtained from BD Biosciences (BD, Franklin Lakes, NJ).	This sentence does not contain fully or partially curatable data, or terms related to the datatype.	This sentence does not contain fully or partially curatable data, or terms related to the datatype.
The LDPE films and PAN fibers were prepared using commercial mulching films (LDPE; thickness, 13.66 ± 2.32 μm, Ihlshin Chemical Co., Ltd., Ansan, South Korea) and knitting wool (100% PAN, DIKTAS Sewing & Knitting Yarns Co., Turkey), respectively. 59	This sentence does not contain fully or partially curatable data, or terms related to the datatype.	This sentence does not contain fully or partially curatable data, or terms related to the datatype.
The intra-and interday precision and accuracy were estimated using three replicates within a single day and across three consecutive days, respectively.	This sentence does not contain fully or partially curatable data, or terms related to the datatype.	This sentence does not contain fully or partially curatable data, or terms related to the datatype.
The graphs of cumulative terpene release, as a function of time at three different dilutions in water (66, 200, and 333 μg/mL), are shown in Figure 6 for terpenes representative of each group classified based on anthelmintic activity.	This sentence does not contain fully or partially curatable data, or terms related to the datatype.	This sentence does not contain fully or partially curatable data, or terms related to the datatype.
APDT with TWE showed effective antimicrobial activity against Staphylococcus aureus, methicillin-resistant Staphylococcus aureus (MRSA), and Candida albicans.	This sentence does not contain fully or partially curatable data, or terms related to the datatype.	This sentence does not contain fully or partially curatable data, or terms related to the datatype.
Our working hypothesis is that their anionic forms probably have significantly reduced membrane activity due to electrostatic repulsion to negatively charged bacterial membranes as shown in the case of anionic forms of PQ401 (Fig. 3).	This sentence does not contain fully or partially curatable data, or terms related to the datatype.	This sentence does not contain fully or partially curatable data, or terms related to the datatype.
Production of Extractable Additive Solutions and Their Effects.	This sentence does not contain fully or partially curatable data, or terms related to the datatype.	This sentence does not contain fully or partially curatable data, or terms related to the datatype.
Only benzimidazoles are currently used in mass drug administration, with many instances of reduced activity.	This sentence does not contain fully or partially curatable data, or terms related to the datatype.	This sentence does not contain fully or partially curatable data, or terms related to the datatype.
In this way, the other isolated compounds were identified as pheophorbide b (1) [23], pheophorbide a (2) [24], 21-epi-pheophorbide a (3) [21], and pheophorbide a ethyl ester (6) [25].	This sentence does not contain fully or partially curatable data, or terms related to the datatype.	This sentence does not contain fully or partially curatable data, or terms related to the datatype.
Still, HDPE fragments (250-630 and <250 μm) significantly reduced the offspring number to 80 ± 10 and 80 ± 8% compared to that of the control, respectively.	This sentence does not contain fully or partially curatable data, or terms related to the datatype.	This sentence does not contain fully or partially curatable data, or terms related to the datatype.
Terpenes and terpenoids are naturally occurring compounds that constitute the primary component of essential oils obtained from plants, and have the potential to be used as anthelmintics.	This sentence does not contain fully or partially curatable data, or terms related to the datatype.	This sentence does not contain fully or partially curatable data, or terms related to the datatype.
We combine the new samples with the C. elegans benchmark dataset (Ye et al., 2017) that was used in the previous works to form a new data set with 18, 747 samples.	This sentence does not contain fully or partially curatable data, or terms related to the datatype.	This sentence does not contain fully or partially curatable data, or terms related to the datatype.
Membrane-active agents typically interact with both bacterial and mammalian lipid bilayers.	This sentence does not contain fully or partially curatable data, or terms related to the datatype.	This sentence does not contain fully or partially curatable data, or terms related to the datatype.
Additional use of conventional spectroscopic techniques such as nuclear magnetic resonance along with MS or a study combining untargeted screening with targeted analysis of suspected compounds could be an option to address the challenges associated with toxicological analyses.	This sentence does not contain fully or partially curatable data, or terms related to the datatype.	This sentence does not contain fully or partially curatable data, or terms related to the datatype.
In the first scenario, the imaged object was a resolution target that was manually  scanned in the vertical direction.	This sentence does not contain fully or partially curatable data, or terms related to the datatype.	This sentence does not contain fully or partially curatable data, or terms related to the datatype.
Second, we did not consider the impact of the genetic defects on the nematode responses to external stimuli.	This sentence does not contain fully or partially curatable data, or terms related to the datatype.	This sentence does not contain fully or partially curatable data, or terms related to the datatype.
One hundred microliters of the supernatant was transferred to a fresh 96-well plate, and absorbance of supernatants was measured at 540 nm.	This sentence does not contain fully or partially curatable data, or terms related to the datatype.	This sentence does not contain fully or partially curatable data, or terms related to the datatype.
Collectively, TCA cycle intermediates should be carefully monitored when examining malfunctions of mitochondria.	This sentence does not contain fully or partially curatable data, or terms related to the datatype.	This sentence does not contain fully or partially curatable data, or terms related to the datatype.
Again, we propose the universal Smad lysine as the primary candidate.	This sentence does not contain fully or partially curatable data, or terms related to the datatype.	This sentence does not contain fully or partially curatable data, or terms related to the datatype.
Finally, unlike cationic antimicrobial agents, the antimicrobial activity of PQ401 is maximized when it exists in its neutral form.	This sentence does not contain fully or partially curatable data, or terms related to the datatype.	This sentence does not contain fully or partially curatable data, or terms related to the datatype.
Here, six-fold cross-validation test is applied, in which the data are divided into six-fold, where onefold is used for testing and the rest of folds are utilized for the training process.	This sentence does not contain fully or partially curatable data, or terms related to the datatype.	This sentence does not contain fully or partially curatable data, or terms related to the datatype.
The wildtype (WT) used was Bristol N2.	This sentence does not contain fully or partially curatable data, or terms related to the datatype.	This sentence does not contain fully or partially curatable data, or terms related to the datatype.
See the figure associated with each protein for the name of the representative sequence from which the lysine number is drawn b Red type indicates the lysine present in all sequences.	This sentence does not contain fully or partially curatable data, or terms related to the datatype.	This sentence does not contain fully or partially curatable data, or terms related to the datatype.
There are 796 homologous positions in the TGFb Type I receptor alignment of 18 sequences, with a total of 518 lysines.	This sentence does not contain fully or partially curatable data, or terms related to the datatype.	This sentence does not contain fully or partially curatable data, or terms related to the datatype.
3-CNN and BLSTM are used to extract deep information from the acquired features and to obtain advanced features.	This sentence does not contain fully or partially curatable data, or terms related to the datatype.	This sentence does not contain fully or partially curatable data, or terms related to the datatype.
Most fast-acting terpenes have a solubility in water higher than the dose tested, allowing for rapid terpene release from YPs in 1-3 h (e.g., carvacrol, Figure 6).	This sentence does not contain fully or partially curatable data, or terms related to the datatype.	This sentence does not contain fully or partially curatable data, or terms related to the datatype.
iNuc-PseKNC predictor was developed by Gou et al. for the discrimination of nucleosome positioning in genomes (Peckham et al. 2007).	This sentence does not contain fully or partially curatable data, or terms related to the datatype.	This sentence does not contain fully or partially curatable data, or terms related to the datatype.
Ethanolextractable additives from PAN fibers showed 38 and 15 features in positive and negative ion modes, respectively.	This sentence does not contain fully or partially curatable data, or terms related to the datatype.	This sentence does not contain fully or partially curatable data, or terms related to the datatype.
Owing to a confined number of genomic and proteomic structure availability, time, and lack of laboratory equipment, the traditional methods remained unsuccessful.	This sentence does not contain fully or partially curatable data, or terms related to the datatype.	This sentence does not contain fully or partially curatable data, or terms related to the datatype.
Rodents deficient in either homolog show RLS-like phenotypes.	This sentence does not contain fully or partially curatable data, or terms related to the datatype.	This sentence does not contain fully or partially curatable data, or terms related to the datatype.
For example, N 1 N 2 N 3 is the first component of tri-nucleotide, N 2 N 3 N 4 is the second component of tri-nucleotide, and so on, while the last component of tri-nucleotide is N L-2 N L-1 N L ; accordingly, the corresponding feature vector 4 × 4 × 4 = 64D is generated.	This sentence does not contain fully or partially curatable data, or terms related to the datatype.	This sentence does not contain fully or partially curatable data, or terms related to the datatype.
Interestingly, PQ401 rescued 100% of C. elegans worms from MRSA infections at one-half the MIC, whereas vancomycin rescued 100% only at 1ϫ MIC (Fig. 6A), indicating that PQ401 may provide additional beneficial bioactivity to combat MRSA infections.	This sentence does not contain fully or partially curatable data, or terms related to the datatype.	This sentence does not contain fully or partially curatable data, or terms related to the datatype.
During the classification process, the predicted outcome of each classifier is varied and can yield different errors.	This sentence does not contain fully or partially curatable data, or terms related to the datatype.	This sentence does not contain fully or partially curatable data, or terms related to the datatype.
Then the Type I receptor phosphorylates a receptor-associated Smad protein (R-Smad), causing the R-Smad to form a complex with a Co-Smad.	This sentence does not contain fully or partially curatable data, or terms related to the datatype.	This sentence does not contain fully or partially curatable data, or terms related to the datatype.
After several tens of nanoseconds of sustained attachment, PQ401 penetrates into the membrane interior, maximizing interactions between a nonpolar benzene ring and hydrophobic lipid tails (Fig. 3A and B and Movie S6).	This sentence does not contain fully or partially curatable data, or terms related to the datatype.	This sentence does not contain fully or partially curatable data, or terms related to the datatype.
"According to Figure 1, ""N2"" should be ""N2(unc-62)""."	This sentence does not contain fully or partially curatable data, or terms related to the datatype.	This sentence does not contain fully or partially curatable data, or terms related to the datatype.
In contrast, our previous studies showed that at least three factors including a molecule's ability to attach to, penetrate, and perturb membrane lipid bilayers play important roles in membrane disruption (6,20,21).	This sentence does not contain fully or partially curatable data, or terms related to the datatype.	This sentence does not contain fully or partially curatable data, or terms related to the datatype.
